bestellen (eine Pizza bestellen) - заказывать
der Schinken (ein Brötchen mit Schinken) - ветчина (бутерброд)
bekommen - приобретать
bezahlen - платить, оплачивать
trennen (Zahlt sie zusammen oder getrennt?) - отделять, разделять (оплата вместе или раздельно - каждый за себя)
das Gericht - блюдо; суд
nennen - называть
die Brille - очки
der Kursteilnehmer - посетитель курсов
der Aufzug - лифт
der Zettel - листок бумаги, записка
das Etui (die Brillenetui) - футляр
die Anzeige - извещение; объявление
raten (I see was, was du nicht siehst) - гадать, отгадывать
die Jugendherberge - молодёжная туристская база; молодежный ночлег
draußen - снаружи, во дворе; на улице
der Sessel - кресло
bequem - удобный, уютный
die Spüle - мойка
dreckig - грязный
aufräumen (Ich räume meine Wohnung auf) - убирать, наводить порядок
einräumen (Ich räume die Spülmaschine ein)- расставлять
der Stau - пробка, скопление
die Panne (Mein Auto hatte eine Panne) - авария, поломка
absagen - отменять
der Friseur - парикмахер
der Erfolg (Viel Erfolg! / Viel Glück!) - успех, удача
der Erzieher - воспитатель (детского сада)
die Mappe - папка, портфель
hassen - ненавидеть
die Ampel - светофор, висячая лампа
biegen (biegen Sie rechts in die Bruchstraße) - огибать
überqueren - проезжать, пересекать
die Gurke - огурец
die Beilage - приправа (к еде)
lecker - аппетитный, лакомый
furchtbar - страшно
ständig (als immer) - постоянно
entspannen (ein spannender Roman)- расслаблять, ослаблять напряжение; отдыхать
anstrengen - утомлять; стараться
riesig - огромный, исполинский
die Metzgerei - мясная лавка
der Gefallen (Könnt ihr mir einen Gefallen tun?) - одолжение, удовольствие
die Dattel - финик
günstig (günstiger Wind) - благоприятно
der Schluß (Und zum Schlusslegst du alles auf den Pizzateig) - конец
schieben (und schieben Sie die Pizza für 20 Minuten in den Ofen) - двигать, толкать
braten - жарить, печь
zelten (Im Urlaub kann man am Meer zelten) - жить в палатке
gerade (Was machst du gerade?)- прямо сейчас
vermissen (ich vermisse den Strand jetzt schon) - замечать отсутствие, скучать
vergleichen (Jahreszeiten vergleichen) - сравнивать
bekommen (Die Bäume bekommen grüne Blätter in der Früling.) - получать, приобретать
nass (Im Herbst ist es nass, regnerisch und meistens windig.) - мокрый
schlimm (die Sache steht schlimm) - плохой, скверный
obdachlos (das Dach) - бездомный (крыша, кровля, дом)
frieren (Im Oktober ist es schon kalt und ich will nicht frieren!) - мерзнуть
der Ausflug (Aber es war kein Urlaub. Das war nurein Ausflug.) - экскурсия, прогулка
bewölken - покрываться тучами
heiter - веселый, радостный; солнечный
trocken - сухой, высохший
die Mütze - шапка
anziehen - одевать, надевать одежду
dünn - тонкий, редкий, мелкий
mischen - смешивать
dick - толстый, тучный
eng - узкий, тесный
weit - дальний; посторный, широкий
gestreift - полосатый
kariert - клетчатый
die Überraschung - неожиданность, сюрприз
ledig - холостой
verheiraten - женить, выдавать замуж
der Neffe (die Nichte) - племянник(ца)
bewegen - двигаться, передвигаться
die Ernährung - питание, пища
empfehlen - советовать, рекомендовать
abnehmen - худеть
verletzen - повредить, поранить
stürzen - сваливаться, падать
weh (Wo tut denn es genau weh? Mein Fuß tut weh. "Weh tun") - болеть
schwellen - опухать, разбухать
bluten - кровоточить
die Schulter - плечо
die Laune - нвстроение, расположение духа
die Behandlungsraum - процедурный кабинет, кабинет врача
trotzdem - не смотря на это
die Krücke - костыль, клюка
die Salbe - мазь
umziehen - переезжать
locker - легкомысленный, свободный
die Zukunft - будущее
die Bremse - тормоз
verdienen - заслуживать
belügen - обманывать
kümmern - заботить, печалить, огорчать
wütend - яростный, рассвирипевший
anmelden - заявлять, уведомлять
die Münze - монета
das Geldschein - банкнот
