geizig (Meine Frau ist geizig) - скупой, жадный
leisten sich (Das kann ich mir nicht leisten) - позволить себе
abheben (Mit der EC-Karte kann man Geld am Bankautomaten abheben) - снимать; брать (трубку)
leihen - давать взаимы, одалживать
der Räuber (der Räuber der Herzen) - грабитель, разбойник
der Vorgesetzter - начальник
das Geschlecht - род, поколение; грамм. род; биол. пол
die Miete - аренда, прокат
schicken - посылать, отправлять
die Erinnerung - напоминание
überweisen - передавать, направлять; переводить (деньги)
der Betrag - сумма, стоимость, итог
die Mahnung - напоминание, предостережение
der Zahlungsausgang - платеж
der Zahlungseingang - получение платежа
verbrauchen - потреблять, расходовать
der Empfänger - получатель
die Bestellung - заказ
abbuchen - списывать со счета
der Dauerauftrag - плат. поручение банка
die Ein/Auszahlung - взнос/выдача денег
die Bestätigung - подтверждение
der Kontoauszug - выписка со счета
der Umsatz - оборот по счетам
der Empfänger - получатель (платежа)
der Abbruch - внезпное прекращение (esc банкомата)
das Gehalt - жалование
die PIN eingeben/eintippen - вводить пин
Geld überweisen -
Rechnungen bezahlen - 
Kontoauszuge drücken 
einen Kredit aufnehmen
in Raten zahlen 
schieben - двигать, толкать
geschieden - разведенный
abhauen - убегать; отсекать, отрубать
erwachsen - взрослый
verwitwet - овдовевший
das Heim - родной дом; приют, прибежище
der Flüchtling - беглец, беженец
die Pflege - уход, забота, попечение
der Gehstock - палка для ходьбы; трость
der Kreislauf (ein Kreislaufzusammenbruch) - круговорот, круговой процесс, циркуляция
die Beschwerde - жалоба, недуг
die Verzeihung - прощение, извинение (формальное "Извините")
blenden (Und wie geht es Ihnen? Blendend!) - слепить; очаровывать
die Kleinigkeit - мелочь, пустяк, безделица
der Müll - мусор
raus/wegbringen - выносить, убирать
fegen - мести, подметать
wischen - тереть, вытирать
der Lappen - тряпка, лоскут, ветошь
schaffen (die Schopfung) - работать, трудиться
(un)höflich - (не)вежливо
die Rücksicht - внимание, уважение, оглядка
das Verhalten - поведение, образ действий
schwanger - беременный
erziehen - воспитывать, выращивать, вскармливать
betreuen - заботится, ухаживать	
pflichtig (schulpflichtig) - обязанный
abholen - заходить, забирать
der Unterschied - разница, отличие
umziehen - переезжать
wiegen (das Wiegenlied) - качать, раскачивать; убаюкивать
anstoßen - подталкиать, придвигать; чокаться
ausfallen (der Flug ist ausgefallen) - выпадать, вываливаться (Ausfallen: .. в осадок)
ziemlich (ziemlich müde) - порядочно, довольно (устал)
trotzen (Trotz allem–prost!) - упрямится, упорствовать
holen (Papa hat mir gesagt, dass ich dich zurückholen soll.) - приносить, привозить, приводить
die Unterkunft - жилое помещение
angenehm - приятно
erholsam - содействующий отдыху
der Umstand - обстоятельство, ситуация, условия жизни, хлопоты
inbegriffen (Ein Cocktail am ersten Abend ist im Preis inbegriffen.) - включительно
abfahren (!abcommen, Wo fährt der Zug ab?) - отъезжать, отправляться
umsteigen - пересаживаться
das Gleis (Auf Gleisen fahren Züge) - жд путь
vermuten - предполагать, догадываться
der Bahnsteig - платформа, перрон
entwerten - компостировать билет
der Rabatt - скидка
die Ermäßigung - скидка
die Kiste - ящик, сундук
die Redewendung - оборот речи, выражение, идиома
unterhalten (sich) - развлекаться
die Bedingung - условие
überlegen - размышлять
entscheiden - решать, разрешать (вопрос, проблему)
einziehen - въезжать
erledigen - доделать
erholen - отдыхать
überraschen - поражать, удивлять
trauen - осмеливаться, решаться	
enttäuscht von D - расстроенный, разочарованный
sich ärgern über A - сердится, злиться, досадовать
sich aufregen über A - волноваться, нервничать, суетится
die Stelle - место, положение, работа, должность
zusagen - обещать, давать согласие
mitteilen - сообщать, передавать (формальное "говорить, писать")
der Umschlag (der Briefumschag) - обертка, оболочка (коневерт)
klappen (Das klappt bestimmt = Du schaffst das schon) - идти на лад
wütend - яростный, свирепый
Es reicht mir! - довольно!
versprechen + D - обещать
vertrauen + D - доверять, верить
lügen - врать
